111111111
100000C01
1000CH001
10C000E01
10P000001
100000C11
1000H0001
100C00001
111111111
