111111111
1C00C0C01
1110CH001
10C001E01
1CP1010C1
111111111
