111111111
1C0PC0C01
1110CH001
10CH01E01
1C0C010C1
100001001
111111111
