111111111
100000001
10000C001
1C0000001
111110001
100C00011
1P1000001
10H000001
111111111
